11111111111
11C1P000E01
11111111111
