11111111111
11E00PC00C1
11111111111
