11111
1PCC1
1EC11
10C11
11111
