11111111111
11E00P00CC1
11111111111
