111111111111111111111111111111111111
1E00000000000110000000C00000000000C1
1111000000000C1110000000000000001111
11110000000C000000011111110000111111
111000000000000C1111111111000C000111
11P0000111110000000000000C0011111001
11111111111111111111111111111111111
