111111111111111111111111111111111111
1E00000000000110000000C00000000000C1
1111000000000C1110000000000000000011
11110000000C000000011111111110111111
111001111111111C1111111111000C111111
11P0111111111110000000000C0111111111
111111111111111111111111111111111111
