1111111111111
1001E0000P0C1
1111111111111
