1111111111111
10010C000P0C1
1E000100011C1
1111111111111
